10 5
2 2 2 2 2 2 2 2 2 2
4 4 4 4 4 4 4 4 4 4
5 5 5 3 1 1 3 5 5 5
3 3 3 3 3 3 3 3 3 3
2 3 2 3 2 3 2 3 2 3
